{
    "levels": {
        "1": 100,
        "2": 200,
        "3": 300,
        "4": 400,
        "5": 500,
        "6": 600,
        "7": 700,
        "8": 800,
        "9": 900,
        "10": 1000,
        "11": 1100,
        "12": 1200,
        "13": 1300,
        "14": 1400,
        "15": 1500,
        "16": 1600,
        "17": 1700,
        "18": 1800,
        "19": 1900,
        "20": 2000,
        "21": 2100,
        "22": 2200,
        "23": 2300,
        "24": 2400,
        "25": 2500,
        "26": 2600,
        "27": 2700,
        "28": 2800,
        "29": 2900,
        "30": 3000,
        "31": 3100,
        "32": 3200,
        "33": 3300,
        "34": 3400,
        "35": 3500,
        "36": 3600,
        "37": 3700,
        "38": 3800,
        "39": 3900,
        "40": 4000,
        "41": 4100,
        "42": 4200,
        "43": 4300,
        "44": 4400,
        "45": 4500,
        "46": 4600,
        "47": 4700,
        "48": 4800,
        "49": 4900,
        "50": 5025,
        "51": 5150,
        "52": 5275,
        "53": 5400,
        "54": 5525,
        "55": 5650,
        "56": 5775,
        "57": 5900,
        "58": 6025,
        "59": 6150,
        "60": 6275,
        "61": 6400,
        "62": 6525,
        "63": 6650,
        "64": 6775,
        "65": 6900,
        "66": 7025,
        "67": 7150,
        "68": 7275,
        "69": 7400,
        "70": 7525,
        "71": 7650,
        "72": 7775,
        "73": 7900,
        "74": 8025,
        "75": 8150,
        "76": 8275,
        "77": 8400,
        "78": 8525,
        "79": 8650,
        "80": 8775,
        "81": 8900,
        "82": 9025,
        "83": 9150,
        "84": 9275,
        "85": 9400,
        "86": 9525,
        "87": 9650,
        "88": 9775,
        "89": 9900,
        "90": 10025,
        "91": 10150,
        "92": 10275,
        "93": 10400,
        "94": 10525,
        "95": 11000,
        "96": 13000,
        "97": 15000,
        "98": 17000,
        "99": 20000
    },

    "multiplicators": {
        "0": 1,
        "1": 2,
        "2": 3,
        "3": 4,
        "4": 5,
        "5": 6,
        "6": 7,
        "7": 8,
        "8": 9,
        "9": 10,
        "10": 11,
        "11": 12,
        "12": 13,
        "13": 14,
        "14": 15,
        "15": 16,
        "16": 17,
        "17": 18,
        "18": 19,
        "19": 20
    }

}